11111111111
10000000001
10000000001
10000000C01
1000E000001
10000000001
10C00000C01
10000000001
100P0000001
11111111111