1111111111111111111111111111111111
1P1000000000000C00000C000000000CE1
10100101001000001010010000000101C1
1010010010101010001001000000010101
10000000000C00000000000000000000C1
1111111111111111111111111111111111