11111111111
10000000EC1
10000000001
10000000001
10000000001
10000000001
100000000C1
10000000001
100P0000001
11111111111