11111111111111111111
111111000100111E1111
10001000111000000011
1000000C101010111111
10100001001C10100101
10101011011010000101
1C111010010011111C01
100000C111000C000001
101111101011111C1111
10000000100100000011
1001C000100101110011
11001101111C01000111
11110000000001000101
10P10C11001111011101
10010001101000010001
10011100101111110001
101C0000100100010001
10111100100000011111
10000111111100000011
10000000000000000001
11111111111111111111